0,0,0,0,0,0,0,4,1,2,0,0
7,2,0,0,0,0,0,6,0,6,0,0
0,6,0,0,0,0,0,6,0,6,0,0
0,6,0,0,4,1,1,5,0,6,0,0
0,6,0,0,6,0,0,0,0,6,0,0
0,6,0,0,6,0,4,1,1,5,4,8
0,6,0,0,6,0,6,0,0,0,6,0
0,3,1,1,5,0,3,1,1,1,5,0
0,0,0,0,0,0,0,0,0,0,0,0
