1,2,3,4,5,6,7,8,9,10,11,12
13,2,3,4,5,6,7,8,9,10,11,12
14,2,3,4,5,6,7,8,9,10,11,12
15,2,3,4,5,6,7,8,9,10,11,12
16,2,3,4,5,6,7,8,9,10,11,12
1,2,3,4,5,6,7,8,9,10,11,12
1,2,3,4,5,6,7,8,9,10,11,12
1,2,3,4,5,6,7,8,9,10,11,12
1,2,3,4,5,6,7,8,9,10,11,12
